bgrp,IBuff_Pop,SBuff_Pop,Buff_Pop,Buff_Pct,Lane_PctSB,Lane_PctIB
420030103001,0,0,0,0.0,57.6800003052,42.3199996948
420030103002,1995,0,1995,59.7999992371,4.90000009537,95.0999984741
420030103003,348,0,348,98.5800018311,4.01999998093,95.9800033569
420030103004,311,0,311,98.1100006104,3.42000007629,96.5800018311
420030201001,1422,0,1422,99.0899963379,3.21000003815,96.7900009155
420030201002,876,0,876,93.5899963379,5.26999998093,94.7300033569
420030201003,28,0,28,100.0,0.0,100.0
420030201004,352,190,542,67.9199981689,5.44000005722,94.5599975586
420030201005,8,0,8,88.8899993896,17.9300003052,82.0699996948
420030201006,402,0,402,95.0400009155,12.0799999237,87.9199981689
420030203001,253,0,253,41.0699996948,14.6499996185,85.3499984741
420030305001,865,511,1376,98.6399993896,48.4700012207,51.5299987793
420030305002,848,2,850,100.0,10.220000267,89.7799987793
420030402001,607,179,786,97.8799972534,53.1100006104,46.8899993896
420030402002,1741,0,1741,98.3600006104,10.3999996185,89.5999984741
420030404001,560,0,560,88.0500030518,6.55000019073,93.4499969482
420030404002,1751,41,1792,96.7600021362,27.4500007629,72.5500030518
420030405001,1729,175,1904,100.0,9.02000045776,90.9800033569
420030405002,1753,32,1785,99.7200012207,9.81999969482,90.1800003052
420030406001,2105,107,2212,92.4700012207,4.36999988556,95.6299972534
420030409001,971,33,1004,90.6999969482,45.4599990845,54.5400009155
420030409002,23,1050,1073,94.1200027466,98.1699981689,1.83000004292
420030409003,4,291,295,41.6100006104,100.0,0.0
420030501001,454,44,498,88.3000030518,15.2600002289,84.7399978638
420030501002,323,51,374,89.9000015259,25.7900009155,74.2099990845
420030501003,590,98,688,94.6399993896,6.55000019073,93.4499969482
420030506001,320,449,769,83.1399993896,64.8300018311,35.1699981689
420030506002,242,13,255,52.7999992371,18.3199996948,81.6800003052
420030506003,198,349,547,95.3000030518,85.0199966431,14.9799995422
420030509001,166,950,1116,92.8499984741,87.4100036621,12.5900001526
420030510001,450,352,802,85.8700027466,82.2900009155,17.7099990845
420030510002,721,423,1144,97.6100006104,53.9000015259,46.0999984741
420030511001,902,210,1112,99.1100006104,78.8799972534,21.1200008392
420030603001,1114,0,1114,100.0,4.28000020981,95.7200012207
420030603002,1218,0,1218,99.2699966431,20.2000007629,79.8000030518
420030605001,508,160,668,100.0,43.0499992371,56.9500007629
420030605002,338,241,579,95.5400009155,71.1699981689,28.8299999237
420030703001,568,125,693,100.0,34.6100006104,65.3899993896
420030703002,687,73,760,97.6900024414,45.7599983215,54.2400016785
420030703003,408,268,676,93.1100006104,50.7900009155,49.2099990845
420030705001,454,280,734,58.3899993896,0.0,0.0
420030705002,603,121,724,100.0,19.4200000763,80.5800018311
420030705003,890,110,1000,98.4300003052,19.7700004578,80.2300033569
420030706001,541,366,907,98.4800033569,59.4500007629,40.5499992371
420030706002,705,432,1137,97.9300003052,57.6800003052,42.3199996948
420030708001,593,120,713,98.3399963379,22.7000007629,77.3000030518
420030708002,489,478,967,98.6699981689,68.5299987793,31.4699993134
420030709001,1476,186,1662,94.3199996948,21.6000003815,78.4000015259
420030709002,661,29,690,87.6699981689,0.0,0.0
420030709003,452,358,810,90.8099975586,72.2799987793,27.7199993134
420030709004,922,92,1014,67.9199981689,0.0,0.0
420030802001,715,70,785,74.8300018311,14.4799995422,85.5199966431
420030802002,625,0,625,99.2099990845,9.35000038147,90.6500015259
420030804001,662,4,666,99.8499984741,3.20000004768,96.8000030518
420030804002,699,0,699,99.5699996948,5.61999988556,94.3799972534
420030806001,750,16,766,58.3400001526,0.0,0.0
420030806002,685,0,685,100.0,16.8199996948,83.1800003052
420030807001,748,80,828,98.6900024414,9.72999954224,90.2699966431
420030807002,886,41,927,97.9899978638,9.15999984741,90.8399963379
420030809001,989,0,989,99.4000015259,0.0,100.0
420030809002,755,17,772,100.0,3.02999997139,96.9700012207
420030901001,1308,0,1308,100.0,0.0,100.0
420030901002,481,0,481,89.9100036621,6.80000019073,93.1999969482
420030902001,849,22,871,99.8899993896,4.17000007629,95.8300018311
420030902002,600,78,678,63.8400001526,26.3799991608,73.6200027466
420030902003,536,165,701,100.0,40.8300018311,59.1699981689
420030903001,1081,0,1081,100.0,0.0,100.0
420030903002,548,0,548,100.0,0.0,100.0
420031005001,202,476,678,82.2799987793,80.0699996948,19.9300003052
420031005002,368,487,855,68.1299972534,73.7099990845,26.2900009155
420031011001,1339,0,1339,100.0,0.0,100.0
420031011002,641,0,641,100.0,5.11000013351,94.8899993896
420031011003,603,78,681,98.8399963379,24.6499996185,75.3499984741
420031014001,303,415,718,65.8099975586,61.1699981689,38.8300018311
420031014002,0,0,0,0.0,0.0,0.0
420031014003,321,491,812,98.7799987793,55.0900001526,44.9099998474
420031014004,0,437,437,59.8600006104,0.0,0.0
420031016001,12,16,28,3.26999998093,0.0,0.0
420031017001,507,43,550,90.6100006104,7.42999982834,92.5699996948
420031017002,726,0,726,84.6200027466,0.0,100.0
420031018001,391,264,655,65.1100006104,72.3199996948,27.6800003052
420031018002,932,330,1262,83.25,35.4900016785,64.5100021362
420031102001,361,413,774,95.7900009155,73.1699981689,26.8299999237
420031102002,66,420,486,66.0299987793,89.8199996948,10.1800003052
420031102003,486,656,1142,95.4100036621,69.0500030518,30.9500007629
420031102004,825,312,1137,92.4400024414,53.0699996948,46.9300003052
420031106001,145,460,605,62.4399986267,96.7600021362,3.24000000954
420031106002,0,0,0,0.0,0.0,0.0
420031106003,442,195,637,88.3499984741,44.2799987793,55.7200012207
420031113001,595,118,713,94.1900024414,46.75,53.25
420031113002,409,180,589,94.3899993896,43.7400016785,56.2599983215
420031113003,506,30,536,92.5699996948,38.9099998474,61.0900001526
420031113004,653,7,660,97.1999969482,42.3600006104,57.6399993896
420031114001,428,62,490,85.2200012207,28.9799995422,71.0199966431
420031114002,538,28,566,72.75,0.0,100.0
420031115001,722,0,722,95.3799972534,13.9600000381,86.0400009155
420031115002,1413,39,1452,94.4100036621,27.8299999237,72.1699981689
420031115003,167,0,167,98.2399978638,1.71000003815,98.2900009155
420031115004,623,102,725,94.7699966431,20.6499996185,79.3499984741
420031203001,221,211,432,45.3800010681,60.1800003052,39.8199996948
420031203002,396,179,575,82.3799972534,51.2599983215,48.7400016785
420031204001,492,13,505,93.0,34.5900001526,65.4100036621
420031204002,131,116,247,75.7699966431,58.4799995422,41.5200004578
420031207001,308,109,417,90.6500015259,44.8800010681,55.1199989319
420031207002,349,9,358,100.0,34.9199981689,65.0800018311
420031208001,213,69,282,79.4400024414,87.2200012207,12.779999733
420031208002,415,71,486,96.4300003052,23.4699993134,76.5299987793
420031301001,226,104,330,40.1899986267,92.6299972534,7.36999988556
420031301002,11,27,38,6.96000003815,0.0,0.0
420031301003,152,215,367,67.5899963379,100.0,0.0
420031302001,199,151,350,52.8699989319,0.0,0.0
420031302002,142,76,218,30.7900009155,0.0,0.0
420031303001,255,106,361,100.0,37.9300003052,62.0699996948
420031303002,193,12,205,71.6800003052,14.0,86.0
420031303003,357,114,471,93.0800018311,28.0200004578,71.9800033569
420031304001,344,55,399,100.0,36.7999992371,63.2000007629
420031304002,251,92,343,71.1600036621,50.25,49.75
420031304003,66,15,81,26.1299991608,0.0,0.0
420031306001,307,22,329,57.0200004578,7.19000005722,92.8099975586
420031306002,291,276,567,88.0400009155,53.1199989319,46.8800010681
420031306003,343,317,660,33.9199981689,76.9899978638,23.0100002289
420031401001,828,420,1248,97.5,72.9599990845,27.0400009155
420031401002,753,1019,1772,93.4100036621,80.7200012207,19.2800006866
420031401003,356,61,417,79.1299972534,24.5499992371,75.4499969482
420031401004,655,999,1654,93.3399963379,65.8099975586,34.1899986267
420031402001,360,519,879,96.6999969482,85.0400009155,14.9600000381
420031402002,1002,448,1450,94.2799987793,77.8300018311,22.1700000763
420031403001,404,386,790,100.0,72.8499984741,27.1499996185
420031403002,617,300,917,91.1500015259,53.9199981689,46.0800018311
420031403003,617,281,898,98.4599990845,45.8899993896,54.1100006104
420031403004,351,361,712,97.2699966431,69.5800018311,30.4200000763
420031404001,186,422,608,86.0,89.2799987793,10.720000267
420031404002,321,290,611,94.8799972534,60.7099990845,39.2900009155
420031404003,274,502,776,81.2600021362,88.5800018311,11.4200000763
420031405001,413,216,629,77.5599975586,19.9300003052,80.0699996948
420031405002,333,170,503,96.5500030518,61.9000015259,38.0999984741
420031405003,366,227,593,82.1299972534,68.1100006104,31.8899993896
420031406001,227,582,809,64.1600036621,85.0999984741,14.8999996185
420031406002,274,450,724,94.0299987793,79.5999984741,20.3999996185
420031406003,612,354,966,99.6900024414,49.2700004578,50.7299995422
420031408001,208,580,788,40.8499984741,73.7799987793,26.2199993134
420031408002,1290,295,1585,88.9899978638,12.2700004578,87.7300033569
420031408003,727,26,753,89.2200012207,6.84999990463,93.1500015259
420031410001,456,254,710,76.5100021362,67.1900024414,32.8100013733
420031411001,5,312,317,23.2900009155,96.9300003052,3.06999993324
420031413001,781,393,1174,77.4400024414,45.7099990845,54.2900009155
420031413002,46,629,675,43.0800018311,76.4300003052,23.5699996948
420031413003,1642,131,1773,84.6699981689,0.0,100.0
420031414001,152,298,450,44.9099998474,0.0,0.0
420031414002,202,260,462,67.6399993896,0.0,0.0
420031414003,452,447,899,91.6399993896,62.4399986267,37.5600013733
420031414004,401,376,777,45.7099990845,58.9000015259,41.0999984741
420031414005,773,66,839,86.8499984741,49.2099990845,50.7900009155
420031516001,0,173,173,15.1800003052,0.0,0.0
420031516002,208,370,578,81.5199966431,77.1399993896,22.8600006104
420031516003,8,57,65,12.6499996185,0.0,0.0
420031517001,805,110,915,98.1800003052,30.8600006104,69.1399993896
420031517002,137,287,424,66.7699966431,54.0200004578,45.9799995422
420031517003,9,114,123,16.5499992371,0.0,0.0
420031517004,279,121,400,64.7200012207,0.0,100.0
420031517005,743,0,743,82.0999984741,8.93000030518,91.0699996948
420031517006,543,172,715,65.1200027466,0.0,0.0
420031608001,0,0,0,0.0,0.0,0.0
420031608002,293,0,293,47.3300018311,0.0,0.0
420031608003,0,0,0,0.0,0.0,0.0
420031608004,210,79,289,39.3699989319,77.4800033569,22.5200004578
420031609001,957,0,957,99.7900009155,6.44000005722,93.5599975586
420031609002,1830,24,1854,96.9199981689,7.90999984741,92.0899963379
420031702001,613,11,624,99.2099990845,15.4099998474,84.5899963379
420031702002,770,1,771,95.4199981689,5.13000011444,94.8700027466
420031702003,1202,32,1234,99.5999984741,0.0,100.0
420031702004,1049,0,1049,100.0,5.36000013351,94.6399993896
420031706001,164,132,296,90.8000030518,64.7600021362,35.2400016785
420031706002,449,231,680,98.8399963379,58.8800010681,41.1199989319
420031706003,548,70,618,99.8399963379,28.2800006866,71.7200012207
420031803001,873,193,1066,97.4400024414,64.5,35.5
420031803002,666,0,666,100.0,9.80000019073,90.1999969482
420031803003,634,3,637,86.5500030518,12.9499998093,87.0500030518
420031807001,390,191,581,93.7099990845,35.3300018311,64.6699981689
420031807002,407,242,649,94.1900024414,61.0999984741,38.9000015259
420031807003,691,9,700,99.7200012207,17.8299999237,82.1699981689
420031903001,1161,47,1208,98.2099990845,56.8400001526,43.1599998474
420031903002,573,113,686,96.3499984741,55.25,44.75
420031911001,379,341,720,75.5500030518,58.7900009155,41.2099990845
420031911002,331,278,609,41.9399986267,58.7299995422,41.2700004578
420031914001,532,192,724,53.3899993896,98.5500030518,1.45000004768
420031914002,167,558,725,52.4199981689,79.0199966431,20.9799995422
420031915001,360,312,672,99.4100036621,50.6899986267,49.3100013733
420031915002,483,288,771,56.4000015259,0.0,0.0
420031916001,117,226,343,41.8800010681,71.6299972534,28.3700008392
420031916002,159,200,359,45.7900009155,61.3699989319,38.6300010681
420031916003,90,90,180,25.0,66.1299972534,33.8699989319
420031916004,0,0,0,0.0,0.0,0.0
420031916005,172,264,436,39.8199996948,48.6399993896,51.3600006104
420031917001,517,27,544,25.8600006104,0.0,100.0
420031917002,67,12,79,13.7899999619,0.0,0.0
420031917003,707,23,730,94.6800003052,5.69000005722,94.3099975586
420031918001,653,0,653,97.9000015259,0.0,100.0
420031918002,84,30,114,16.6200008392,0.0,0.0
420031918003,355,119,474,67.0400009155,50.3199996948,49.6800003052
420031918004,577,144,721,95.75,17.8899993896,82.1100006104
420031918005,132,179,311,45.1399993896,35.1199989319,64.8799972534
420031918006,27,271,298,30.9099998474,100.0,0.0
420031918007,510,57,567,66.2399978638,13.0500001907,86.9499969482
420031919001,580,0,580,75.7200012207,24.2199993134,75.7799987793
420031919002,727,0,727,87.9100036621,0.0,100.0
420031919003,548,42,590,100.0,24.7199993134,75.2799987793
420031920001,358,29,387,52.7999992371,4.90000009537,95.0999984741
420031920002,437,5,442,66.1699981689,4.82000017166,95.1800003052
420031920003,203,14,217,30.0100002289,29.3899993896,70.6100006104
420031920004,242,0,242,27.1599998474,0.0,100.0
420031920005,52,0,52,7.82999992371,0.0,0.0
420032022001,150,184,334,25.0200004578,45.7799987793,54.2200012207
420032022002,0,0,0,0.0,0.0,0.0
420032022003,0,0,0,0.0,0.0,0.0
420032023001,145,536,681,85.9800033569,70.25,29.75
420032023002,581,85,666,63.9199981689,19.8299999237,80.1699981689
420032023003,645,266,911,94.6999969482,32.3100013733,67.6900024414
420032023004,332,257,589,43.6899986267,76.7399978638,23.2600002289
420032107001,800,69,869,65.0400009155,10.4399995804,89.5599975586
420032107002,485,55,540,68.0100021362,9.25,90.75
420032206001,1304,58,1362,100.0,5.71000003815,94.2900009155
420032206002,468,0,468,100.0,1.42999994755,98.5699996948
420032406001,566,894,1460,95.6699981689,22.5499992371,77.4499969482
420032406002,825,339,1164,97.9800033569,45.8699989319,54.1300010681
420032412001,369,4,373,100.0,56.7799987793,43.2200012207
420032412002,442,68,510,100.0,30.3099994659,69.6900024414
420032503001,967,32,999,91.6500015259,21.0599994659,78.9400024414
420032507001,467,181,648,86.0599975586,51.0499992371,48.9500007629
420032509001,184,388,572,81.7099990845,87.4700012207,12.529999733
420032509002,358,144,502,88.8499984741,25.7999992371,74.1999969482
420032602001,536,83,619,90.5,36.8800010681,63.1199989319
420032602002,743,209,952,93.0599975586,42.3400001526,57.6599998474
420032602003,495,75,570,99.8199996948,29.0300006866,70.9700012207
420032607001,689,22,711,95.4400024414,67.4700012207,32.5299987793
420032607002,755,242,997,100.0,43.8699989319,56.1300010681
420032609001,357,480,837,68.9499969482,50.7400016785,49.2599983215
420032612001,864,91,955,90.8700027466,50.0800018311,49.9199981689
420032614001,295,107,402,60.7299995422,13.1800003052,86.8199996948
420032614002,223,165,388,74.6200027466,56.4700012207,43.5299987793
420032614003,430,178,608,98.0599975586,31.1900005341,68.8099975586
420032614004,428,175,603,94.6600036621,63.6300010681,36.3699989319
420032615001,647,154,801,99.8799972534,54.2000007629,45.7999992371
420032615002,652,209,861,100.0,54.5600013733,45.4399986267
420032620001,342,299,641,52.9799995422,91.75,8.25
420032620002,0,0,0,0.0,0.0,0.0
420032620003,176,124,300,43.8600006104,58.0999984741,41.9000015259
420032701001,1334,171,1505,98.9499969482,28.6800003052,71.3199996948
420032701002,725,388,1113,98.6699981689,59.0699996948,40.9300003052
420032703001,679,282,961,83.2799987793,56.1599998474,43.8400001526
420032703002,262,497,759,95.7099990845,92.1200027466,7.88000011444
420032704001,936,35,971,89.9899978638,28.4599990845,71.5400009155
420032708001,304,240,544,69.9199981689,45.5699996948,54.4300003052
420032708002,760,179,939,94.6600036621,57.0200004578,42.9799995422
420032708003,476,259,735,83.4300003052,36.5400009155,63.4599990845
420032715001,623,58,681,84.1800003052,44.6699981689,55.3300018311
420032715002,973,102,1075,85.0500030518,17.2099990845,82.7900009155
420032715003,695,172,867,79.25,39.8600006104,60.1399993896
420032814001,221,73,294,35.8499984741,24.6200008392,75.3799972534
420032814002,740,247,987,64.6399993896,33.0900001526,66.9100036621
420032815001,318,185,503,100.0,55.2200012207,44.7799987793
420032815002,664,273,937,97.7099990845,66.5999984741,33.4000015259
420032901001,565,71,636,96.5100021362,48.5800018311,51.4199981689
420032901002,649,63,712,95.6999969482,8.73999977112,91.2600021362
420032901003,526,19,545,76.0100021362,0.0,100.0
420032902001,148,336,484,53.6599998474,98.3899993896,1.61000001431
420032902002,683,137,820,99.7600021362,42.75,57.25
420032902003,527,56,583,90.25,8.77000045776,91.2300033569
420032902004,446,153,599,85.6900024414,19.9699993134,80.0299987793
420032902005,512,142,654,74.7399978638,27.2000007629,72.8000030518
420032904001,301,70,371,64.0800018311,17.8700008392,82.1299972534
420032904002,1021,170,1191,94.75,40.7599983215,59.2400016785
420032904003,587,110,697,98.7300033569,45.5699996948,54.4300003052
420032904004,146,286,432,49.7700004578,64.5199966431,35.4799995422
420032904005,542,9,551,86.2300033569,9.18000030518,90.8199996948
420033001001,145,67,212,52.6100006104,7.36999988556,92.6299972534
420033001002,173,19,192,38.0999984741,0.0,0.0
420033001003,306,0,306,37.6399993896,0.0,100.0
420033001004,329,42,371,51.5299987793,0.0,100.0
420033001005,301,46,347,54.2999992371,19.5799999237,80.4199981689
420033001006,395,51,446,66.7699966431,20.6700000763,79.3300018311
420033102001,357,75,432,65.2600021362,31.3899993896,68.6100006104
420033102002,499,94,593,90.5299987793,24.6399993896,75.3600006104
420033102003,374,44,418,76.6999969482,14.220000267,85.7799987793
420033102004,333,200,533,74.0299987793,71.5,28.5
420033102005,116,33,149,23.1000003815,18.4300003052,81.5699996948
420033103001,87,70,157,15.9099998474,69.0699996948,30.9300003052
420033204001,629,100,729,96.6800003052,28.4500007629,71.5500030518
420033204002,442,144,586,88.25,61.7900009155,38.2099990845
420033204003,228,289,517,89.7600021362,34.3499984741,65.6500015259
420033206001,724,25,749,64.6800003052,10.5900001526,89.4100036621
420033206002,935,91,1026,93.0199966431,28.7000007629,71.3000030518
420033207001,435,11,446,39.2299995422,29.6599998474,70.3399963379
420033207002,279,225,504,98.25,42.8699989319,57.1300010681
420034011001,841,296,1137,79.7900009155,55.3699989319,44.6300010681
420034011002,499,107,606,50.5800018311,41.2200012207,58.7799987793
420034011003,374,62,436,52.4700012207,14.6000003815,85.4000015259
420034011004,594,118,712,71.6999969482,21.4200000763,78.5800018311
420034012001,0,0,0,0.0,0.0,0.0
420034012002,410,96,506,46.0800018311,15.1899995804,84.8099975586
420034012003,0,0,0,0.0,0.0,0.0
420034012004,184,27,211,28.1000003815,27.5900001526,72.4100036621
420034013001,853,119,972,74.4800033569,22.8799991608,77.1200027466
420034013002,138,69,207,34.3300018311,53.4199981689,46.5800018311
420034013003,388,339,727,87.1699981689,36.4000015259,63.5999984741
420034020001,472,29,501,80.1600036621,4.63000011444,95.3700027466
420034020002,0,0,0,0.0,0.0,0.0
420034020003,417,89,506,44.7799987793,10.3999996185,89.5999984741
420034020004,0,0,0,0.0,0.0,0.0
420034035001,652,159,811,90.7200012207,42.2599983215,57.7400016785
420034035002,698,42,740,97.5,21.7399997711,78.2600021362
420034035003,802,43,845,69.7200012207,32.0499992371,67.9499969482
420034035004,151,0,151,16.4099998474,4.28000020981,95.7200012207
420034035005,734,11,745,100.0,3.19000005722,96.8099975586
420034040001,1023,163,1186,79.0699996948,35.2700004578,64.7300033569
420034050002,106,49,155,32.7700004578,56.8800010681,43.1199989319
420034070012,663,115,778,60.3100013733,45.8400001526,54.1599998474
420034070013,863,171,1034,62.0999984741,55.1599998474,44.8400001526
420034070014,544,210,754,49.6399993896,64.8899993896,35.1100006104
420034070021,669,313,982,70.8000030518,61.7099990845,38.2900009155
420034070022,809,388,1197,75.6600036621,69.2799987793,30.7199993134
420034070023,543,103,646,77.7399978638,45.5499992371,54.4500007629
420034070024,941,918,1859,66.4599990845,64.8199996948,35.1800003052
420034080011,578,142,720,60.7099990845,34.3100013733,65.6900024414
420034080012,469,298,767,36.0900001526,51.9599990845,48.0400009155
420034080013,348,206,554,38.0,53.1300010681,46.8699989319
420034080021,554,774,1328,34.8400001526,59.8300018311,40.1699981689
420034080022,769,334,1103,43.7900009155,40.9399986267,59.0600013733
420034090001,1484,823,2307,61.6699981689,60.7700004578,39.2299995422
420034090002,532,677,1209,54.0,67.5299987793,32.4700012207
420034090003,1030,361,1391,43.2000007629,49.4000015259,50.5999984741
420034090004,925,203,1128,49.1100006104,27.5699996948,72.4300003052
420034100001,80,395,475,40.5600013733,96.9000015259,3.09999990463
420034110001,561,129,690,63.2400016785,37.5099983215,62.4900016785
420034110002,874,929,1803,68.6600036621,70.6299972534,29.3700008392
420034110003,634,596,1230,38.4599990845,62.3499984741,37.6500015259
420034120011,981,584,1565,58.6599998474,52.1199989319,47.8800010681
420034120012,936,357,1293,71.9899978638,67.8300018311,32.1699981689
420034120013,746,388,1134,66.3899993896,40.5400009155,59.4599990845
420034120014,614,706,1320,54.25,68.8899993896,31.1100006104
420034120021,1157,964,2121,72.4100036621,53.0099983215,46.9900016785
420034120022,503,504,1007,52.0099983215,69.8700027466,30.1299991608
420034131001,129,469,598,46.4599990845,90.1900024414,9.81000041962
420034131002,35,194,229,11.470000267,0.0,0.0
420034131003,551,138,689,48.25,31.8299999237,68.1699981689
420034131004,382,85,467,24.6200008392,38.0600013733,61.9399986267
420034132011,378,113,491,62.3100013733,62.9000015259,37.0999984741
420034132012,478,384,862,65.5,66.8499984741,33.1500015259
420034132013,640,368,1008,61.7299995422,52.2900009155,47.7099990845
420034132021,465,266,731,66.9400024414,72.0699996948,27.9300003052
420034132022,273,547,820,46.2200012207,82.4300003052,17.5699996948
420034133001,714,145,859,51.0400009155,32.3699989319,67.6299972534
420034133002,380,407,787,33.25,63.2599983215,36.7400016785
420034133003,26,303,329,47.5400009155,96.7099990845,3.28999996185
420034134001,357,604,961,62.0800018311,69.5,30.5
420034134002,502,303,805,67.1399993896,52.5600013733,47.4399986267
420034134003,149,266,415,26.0699996948,83.8600006104,16.1399993896
420034135001,299,328,627,71.9000015259,68.5699996948,31.4300003052
420034135002,629,935,1564,73.8799972534,63.6100006104,36.3899993896
420034135003,265,370,635,46.2200012207,57.5800018311,42.4199981689
420034135004,785,401,1186,65.8499984741,54.8899993896,45.1100006104
420034141011,482,334,816,38.2000007629,38.8400001526,61.1599998474
420034141012,340,341,681,56.2299995422,79.4899978638,20.5100002289
420034141013,560,101,661,80.1200027466,41.9000015259,58.0999984741
420034141014,355,437,792,66.7799987793,73.1699981689,26.8299999237
420034141021,809,524,1333,50.3600006104,55.5600013733,44.4399986267
420034141022,248,420,668,26.8400001526,73.1999969482,26.7999992371
420034141023,160,279,439,23.0599994659,68.5599975586,31.4400005341
420034142001,796,678,1474,45.75,73.9499969482,26.0499992371
420034142002,417,309,726,74.7699966431,58.1399993896,41.8600006104
420034142003,210,471,681,38.4300003052,87.4599990845,12.5399999619
420034150011,504,283,787,70.9000015259,77.4000015259,22.6000003815
420034150012,497,440,937,62.2200012207,63.8800010681,36.1199989319
420034150013,287,364,651,31.1599998474,81.3799972534,18.6200008392
420034150021,575,473,1048,71.4400024414,83.25,16.75
420034150022,562,326,888,82.3700027466,70.0,30.0
420034160001,699,121,820,91.9300003052,27.4799995422,72.5199966431
420034160002,19,11,30,4.03000020981,66.6100006104,33.3899993896
420034171001,458,102,560,67.6299972534,20.0900001526,79.9100036621
420034171002,524,83,607,86.0999984741,21.6599998474,78.3399963379
420034171003,57,34,91,14.8699998856,58.1300010681,41.8699989319
420034172001,1018,28,1046,83.0199966431,21.3600006104,78.6399993896
420034180001,1155,219,1374,78.6900024414,18.0300006866,81.9700012207
420034190001,801,158,959,86.7900009155,50.4000015259,49.5999984741
420034190002,530,48,578,79.1800003052,23.2099990845,76.7900009155
420034190003,310,256,566,52.1199989319,75.4700012207,24.5300006866
420034200001,1161,98,1259,87.9199981689,5.86000013351,94.1399993896
420034211001,206,470,676,63.3600006104,82.8700027466,17.1299991608
420034211002,331,375,706,83.5500030518,72.9300003052,27.0699996948
420034211003,400,350,750,48.5099983215,49.2200012207,50.7799987793
420034211004,94,410,504,78.1399993896,64.6100006104,35.3899993896
420034212001,528,513,1041,53.1399993896,70.7200012207,29.2800006866
420034212002,287,465,752,69.1800003052,71.3300018311,28.6700000763
420034212003,79,108,187,75.7099990845,53.9199981689,46.0800018311
420034212004,356,383,739,73.6800003052,79.7399978638,20.2600002289
420034220001,174,667,841,48.0,97.0999984741,2.90000009537
420034220002,71,363,434,57.4099998474,92.9199981689,7.07999992371
420034220003,93,305,398,38.0499992371,94.5400009155,5.46000003815
420034220004,214,380,594,32.3899993896,91.6399993896,8.35999965668
420034230001,172,454,626,65.3399963379,72.2399978638,27.7600002289
420034230002,739,250,989,99.3000030518,42.1100006104,57.8899993896
420034230003,582,265,847,100.0,40.3400001526,59.6599998474
420034240001,923,8,931,99.4700012207,62.3300018311,37.6699981689
420034240002,420,10,430,64.7600021362,14.25,85.75
420034240003,644,2,646,86.25,10.8199996948,89.1800003052
420034240004,1044,0,1044,95.1699981689,61.8400001526,38.1599998474
420034250001,491,24,515,93.4700012207,36.4599990845,63.5400009155
420034250002,450,63,513,53.5499992371,16.5900001526,83.4100036621
420034250003,944,94,1038,94.0199966431,32.1100006104,67.8899993896
420034250004,651,173,824,99.4000015259,36.4399986267,63.5600013733
420034263001,811,614,1425,90.25,55.8800010681,44.1199989319
420034263002,379,660,1039,49.8600006104,81.0299987793,18.9699993134
420034263003,123,345,468,19.7099990845,85.0699996948,14.9300003052
420034264001,522,199,721,78.8799972534,40.1399993896,59.8600006104
420034264002,661,280,941,89.0299987793,46.3100013733,53.6899986267
420034264003,604,431,1035,96.9100036621,71.8899993896,28.1100006104
420034264004,797,550,1347,87.3499984741,58.3699989319,41.6300010681
420034267001,133,182,315,45.1899986267,65.5800018311,34.4199981689
420034267002,901,623,1524,91.5899963379,52.3800010681,47.6199989319
420034268001,391,206,597,44.8899993896,62.6199989319,37.3800010681
420034268002,180,117,297,11.8599996567,35.3800010681,64.6200027466
420034268003,160,133,293,19.1000003815,59.5099983215,40.4900016785
420034270001,1211,72,1283,88.9100036621,23.0400009155,76.9599990845
420034270002,812,7,819,97.7300033569,34.5999984741,65.4000015259
420034270003,1463,0,1463,100.0,5.84999990463,94.1500015259
420034271001,252,228,480,28.0,71.9499969482,28.0499992371
420034271002,367,807,1174,65.6200027466,80.3199996948,19.6800003052
420034271003,196,835,1031,51.3699989319,91.1699981689,8.82999992371
420034272001,196,74,270,21.4099998474,0.0,0.0
420034272002,363,303,666,55.6399993896,56.4799995422,43.5200004578
420034272003,464,468,932,73.0999984741,57.8699989319,42.1300010681
420034272004,424,115,539,46.2299995422,35.2700004578,64.7300033569
420034281001,16,95,111,17.5599994659,0.0,0.0
420034281002,0,331,331,55.7200012207,0.0,0.0
420034282001,344,135,479,74.8399963379,71.9300003052,28.0699996948
420034282002,572,323,895,61.6800003052,61.8300018311,38.1699981689
420034291001,730,263,993,88.1100006104,48.7999992371,51.2000007629
420034291002,825,250,1075,77.9000015259,55.7900009155,44.2099990845
420034292011,238,726,964,51.0099983215,68.7699966431,31.2299995422
420034292012,597,166,763,31.5300006866,18.6100006104,81.3899993896
420034292021,447,486,933,76.7900009155,76.9499969482,23.0499992371
420034292022,262,675,937,69.6100006104,75.3700027466,24.6299991608
420034292023,551,641,1192,66.0800018311,54.3699989319,45.6300010681
420034293001,724,417,1141,58.1300010681,74.2399978638,25.7600002289
420034293002,702,376,1078,76.2900009155,68.5,31.5
420034293003,252,87,339,25.7600002289,42.2900009155,57.7099990845
420034293004,81,56,137,14.3900003433,72.5199966431,27.4799995422
420034294001,474,71,545,92.6900024414,37.1500015259,62.8499984741
420034294002,758,76,834,49.4099998474,18.4099998474,81.5899963379
420034294003,250,134,384,30.2399997711,72.1900024414,27.8099994659
420034294004,339,152,491,68.2900009155,51.25,48.75
420034295001,1049,221,1270,68.0599975586,27.6599998474,72.3399963379
420034295002,1321,1,1322,78.1299972534,1.42999994755,98.5699996948
420034295003,455,109,564,86.2399978638,37.2000007629,62.7999992371
420034296001,987,392,1379,56.7700004578,46.6800003052,53.3199996948
420034296002,245,395,640,64.0599975586,62.9000015259,37.0999984741
420034297001,1171,252,1423,96.2099990845,30.7199993134,69.2799987793
420034297002,252,540,792,88.9899978638,77.1800003052,22.8199996948
420034301001,103,90,193,26.4400005341,39.7700004578,60.2299995422
420034301002,627,214,841,61.2099990845,34.8100013733,65.1900024414
420034302001,553,251,804,100.0,60.6300010681,39.3699989319
420034302002,959,112,1071,84.8000030518,41.4900016785,58.5099983215
420034302003,837,75,912,89.2399978638,27.1299991608,72.8700027466
420034302004,582,49,631,81.8399963379,7.86000013351,92.1399993896
420034302005,0,0,0,0.0,0.0,0.0
420034311001,1383,210,1593,95.1600036621,62.2200012207,37.7799987793
420034311002,973,517,1490,87.3399963379,51.0299987793,48.9700012207
420034314001,443,70,513,26.9699993134,45.1699981689,54.8300018311
420034315001,468,57,525,81.5199966431,8.13000011444,91.8700027466
420034315002,418,32,450,53.4399986267,9.13000011444,90.8700027466
420034315003,870,12,882,100.0,3.07999992371,96.9199981689
420034315004,324,262,586,81.3899993896,43.6500015259,56.3499984741
420034323001,282,21,303,27.25,14.5,85.5
420034323002,432,246,678,67.1999969482,13.9399995804,86.0599975586
420034324001,985,15,1000,100.0,7.71999979019,92.2799987793
420034324002,372,270,642,79.2600021362,57.6199989319,42.3800010681
420034324003,441,296,737,95.2200012207,25.9899997711,74.0100021362
420034340001,130,303,433,48.8699989319,71.6500015259,28.3500003815
420034340002,68,402,470,52.5099983215,84.6100006104,15.3900003433
420034350001,794,325,1119,85.75,49.3300018311,50.6699981689
420034350002,926,175,1101,96.2399978638,42.0200004578,57.9799995422
420034370001,859,433,1292,50.7099990845,43.4500007629,56.5499992371
420034370002,561,616,1177,53.2799987793,63.0499992371,36.9500007629
420034390001,662,348,1010,72.7699966431,66.8199996948,33.1800003052
420034455001,469,369,838,76.8099975586,44.6500015259,55.3499984741
420034455002,688,869,1557,95.4000015259,70.1500015259,29.8500003815
420034455003,829,247,1076,98.3499984741,44.0200004578,55.9799995422
420034460001,87,453,540,61.3600006104,94.9800033569,5.01999998093
420034460002,142,639,781,97.6200027466,78.1900024414,21.8099994659
420034470001,787,480,1267,77.5400009155,69.3099975586,30.6900005341
420034480001,1049,140,1189,97.6200027466,36.4799995422,63.5200004578
420034490001,1064,724,1788,67.7300033569,62.1599998474,37.8400001526
420034507001,830,131,961,63.5999984741,49.0200004578,50.9799995422
420034507002,1159,81,1240,76.2600021362,28.7800006866,71.2200012207
420034508001,1139,0,1139,86.6800003052,1.96000003815,98.0400009155
420034508002,519,0,519,100.0,3.55999994278,96.4400024414
420034508003,444,102,546,77.2300033569,55.2299995422,44.7700004578
420034511011,630,409,1039,51.7200012207,65.0599975586,34.9399986267
420034511012,706,42,748,45.8899993896,43.8400001526,56.1599998474
420034511021,150,345,495,26.4599990845,57.2799987793,42.7200012207
420034511022,63,136,199,20.9300003052,77.3099975586,22.6900005341
420034511023,499,761,1260,44.9199981689,61.6699981689,38.3300018311
420034511041,31,27,58,1.97000002861,67.1100006104,32.8899993896
420034511042,168,50,218,33.4399986267,38.0499992371,61.9500007629
420034511051,666,485,1151,79.3799972534,21.0400009155,78.9599990845
420034511052,340,46,386,42.5099983215,16.3199996948,83.6800003052
420034511053,812,127,939,51.0900001526,27.6299991608,72.3700027466
420034513001,799,413,1212,34.9700012207,50.4199981689,49.5800018311
420034513002,212,92,304,22.6700000763,57.1800003052,42.8199996948
420034513003,577,424,1001,69.4700012207,71.0800018311,28.9200000763
420034513004,377,245,622,70.2799987793,61.9399986267,38.0600013733
420034520002,209,65,274,15.7100000381,36.0900001526,63.9099998474
420034520003,529,233,762,48.8499984741,23.0400009155,76.9599990845
420034530032,473,89,562,91.0899963379,57.2400016785,42.7599983215
420034530041,149,82,231,12.3299999237,45.3100013733,54.6899986267
420034530042,618,60,678,34.8800010681,18.4300003052,81.5699996948
420034530043,506,142,648,27.5400009155,40.5499992371,59.4500007629
420034530044,150,78,228,29.0400009155,38.5099983215,61.4900016785
420034550001,822,341,1163,79.7099990845,44.2799987793,55.7200012207
420034560011,471,141,612,64.2900009155,31.0599994659,68.9400024414
420034560012,508,498,1006,39.1300010681,69.5699996948,30.4300003052
420034560031,495,56,551,62.1199989319,38.4599990845,61.5400009155
420034560032,902,489,1391,47.2799987793,56.0299987793,43.9700012207
420034560033,434,375,809,35.6100006104,62.0,38.0
420034560041,479,550,1029,59.6199989319,45.7099990845,54.2900009155
420034560042,1444,760,2204,71.8899993896,48.6599998474,51.3400001526
420034571001,630,121,751,98.4300003052,42.5900001526,57.4099998474
420034571002,657,1,658,98.9499969482,6.67000007629,93.3300018311
420034572001,295,278,573,96.9499969482,68.7900009155,31.2099990845
420034572002,719,128,847,100.0,36.7099990845,63.2900009155
420034572003,768,385,1153,83.6699981689,50.7799987793,49.2200012207
420034572004,360,125,485,53.6500015259,0.0,0.0
420034580001,178,54,232,36.5900001526,36.5999984741,63.4000015259
420034580002,847,179,1026,30.1200008392,43.1100006104,56.8899993896
420034580003,806,565,1371,78.7900009155,77.7699966431,22.2299995422
420034580004,323,250,573,44.0800018311,44.8300018311,55.1699981689
420034591011,762,393,1155,67.6200027466,45.6100006104,54.3899993896
420034591021,963,641,1604,77.0,49.4000015259,50.5999984741
420034591022,225,298,523,52.8300018311,68.0,32.0
420034591023,451,432,883,34.1599998474,73.8600006104,26.1399993896
420034592011,548,453,1001,60.9300003052,50.6800003052,49.3199996948
420034592012,996,282,1278,64.0,44.1399993896,55.8600006104
420034592013,629,77,706,40.0,22.2800006866,77.7200012207
420034592014,337,105,442,75.8099975586,36.8199996948,63.1800003052
420034592021,151,467,618,93.4899978638,96.6800003052,3.31999993324
420034600011,1542,417,1959,74.9700012207,60.4000015259,39.5999984741
420034600012,550,212,762,46.5499992371,44.7099990845,55.2900009155
420034600021,427,153,580,90.4800033569,49.6100006104,50.3899993896
420034600022,906,539,1445,72.4300003052,52.6399993896,47.3600006104
420034600023,268,21,289,36.7700004578,36.1300010681,63.8699989319
420034610001,953,24,977,90.1299972534,15.5399999619,84.4599990845
420034621001,171,109,280,43.5499992371,33.9099998474,66.0899963379
420034621002,88,183,271,45.1699981689,83.0599975586,16.9400005341
420034621003,784,478,1262,91.5800018311,68.4899978638,31.5100002289
420034626001,381,337,718,81.9599990845,79.5299987793,20.4699993134
420034626002,322,441,763,88.6200027466,84.3399963379,15.6599998474
420034626003,429,145,574,74.6399993896,34.1100006104,65.8899993896
420034626004,718,69,787,66.1299972534,54.7099990845,45.2900009155
420034639001,1077,27,1104,92.6200027466,39.2700004578,60.7299995422
420034639002,559,82,641,88.0500030518,16.0799999237,83.9199981689
420034639003,427,0,427,57.5499992371,0.0,100.0
420034643001,861,266,1127,86.8899993896,31.5599994659,68.4400024414
420034643002,527,110,637,80.7399978638,53.1399993896,46.8600006104
420034643003,650,12,662,99.5500030518,31.4899997711,68.5100021362
420034643004,461,117,578,99.8300018311,53.0299987793,46.9700012207
420034644001,381,35,416,93.0599975586,19.3199996948,80.6800003052
420034644002,520,108,628,68.1100006104,29.4099998474,70.5899963379
420034644003,930,132,1062,98.2399978638,7.23999977112,92.7600021362
420034644004,658,17,675,68.0400009155,2.15000009537,97.8499984741
420034656001,584,349,933,93.7699966431,65.75,34.25
420034656002,1194,62,1256,91.3499984741,48.0900001526,51.9099998474
420034658001,714,588,1302,84.2699966431,63.5200004578,36.4799995422
420034658002,550,138,688,60.2999992371,27.8999996185,72.0999984741
420034658003,0,13,13,1.46000003815,0.0,0.0
420034687001,524,395,919,86.4499969482,28.3500003815,71.6500015259
420034687002,209,105,314,45.1100006104,0.0,0.0
420034688001,568,0,568,91.4700012207,0.0,100.0
420034688002,567,141,708,99.3000030518,20.7600002289,79.2399978638
420034688003,338,438,776,62.6800003052,82.1200027466,17.8799991608
420034689001,752,368,1120,87.7099990845,57.4300003052,42.5699996948
420034689002,505,126,631,67.6299972534,34.5999984741,65.4000015259
420034689003,1059,329,1388,97.0,23.2000007629,76.8000030518
420034690001,773,224,997,93.0,42.8899993896,57.1100006104
420034690002,681,957,1638,68.1900024414,66.3099975586,33.6899986267
420034690003,562,292,854,89.1399993896,50.1300010681,49.8699989319
420034703001,362,350,712,43.9199981689,49.2099990845,50.7900009155
420034703002,391,248,639,27.6399993896,50.7400016785,49.2599983215
420034704001,636,135,771,83.3499984741,40.4399986267,59.5600013733
420034704002,70,96,166,22.7999992371,48.7200012207,51.2799987793
420034704003,396,621,1017,72.1299972534,56.5499992371,43.4500007629
420034705011,626,517,1143,45.7200012207,35.9500007629,64.0500030518
420034705012,724,263,987,67.8799972534,30.7099990845,69.2900009155
420034705021,588,403,991,66.6900024414,62.7900009155,37.2099990845
420034705022,657,140,797,53.6699981689,35.5600013733,64.4400024414
420034706001,556,396,952,57.4500007629,45.3699989319,54.6300010681
420034706002,154,134,288,39.6699981689,13.3100004196,86.6900024414
420034706003,154,0,154,21.3899993896,0.0,0.0
420034710001,752,44,796,63.9900016785,1.21000003815,98.7900009155
420034721001,1156,43,1199,81.2300033569,4.13999986649,95.8600006104
420034721002,961,80,1041,99.8099975586,15.1700000763,84.8300018311
420034722001,712,90,802,87.2699966431,10.0399999619,89.9599990845
420034722002,575,8,583,100.0,0.0,100.0
420034722003,446,41,487,67.1699981689,45.7999992371,54.2000007629
420034723001,613,4,617,100.0,6.38000011444,93.6200027466
420034723002,780,5,785,94.4599990845,7.88999986649,92.1100006104
420034723003,398,0,398,70.3199996948,0.0,100.0
420034724001,781,85,866,83.75,8.07999992371,91.9199981689
420034724002,374,132,506,63.7299995422,30.5799999237,69.4199981689
420034731001,340,164,504,35.8699989319,47.1599998474,52.8400001526
420034731002,295,161,456,60.3199996948,87.0800018311,12.9200000763
420034731003,788,123,911,100.0,51.4700012207,48.5299987793
420034731004,433,253,686,99.7099990845,53.7599983215,46.2400016785
420034731005,896,23,919,94.3499984741,32.6300010681,67.3700027466
420034732001,888,52,940,97.6100006104,31.0699996948,68.9300003052
420034732002,815,98,913,90.0400009155,32.7799987793,67.2200012207
420034732003,986,190,1176,96.7900009155,43.0,57.0
420034733001,225,267,492,40.5600013733,63.4399986267,36.5600013733
420034733002,275,487,762,58.3899993896,57.7900009155,42.2099990845
420034733003,108,96,204,16.4599990845,48.2700004578,51.7299995422
420034733004,241,659,900,86.1200027466,83.5899963379,16.4099998474
420034733005,106,130,236,33.7099990845,35.5200004578,64.4800033569
420034734011,269,33,302,43.3899993896,28.7299995422,71.2699966431
420034734012,137,60,197,32.8300018311,0.0,0.0
420034734013,585,90,675,65.8499984741,32.1199989319,67.8799972534
420034734014,333,478,811,58.2599983215,72.2600021362,27.7399997711
420034734021,561,412,973,91.2799987793,64.8799972534,35.1199989319
420034734022,54,30,84,10.529999733,0.0,0.0
420034734023,145,668,813,45.0900001526,82.4300003052,17.5699996948
420034735001,147,209,356,46.1699981689,63.4500007629,36.5499992371
420034735002,14,69,83,9.55000019073,91.6999969482,8.30000019073
420034735003,470,828,1298,63.6300010681,62.7200012207,37.2799987793
420034736011,163,291,454,49.5600013733,73.8000030518,26.2000007629
420034736012,563,471,1034,68.0699996948,59.7000007629,40.2999992371
420034736013,949,290,1239,76.7699966431,43.8600006104,56.1399993896
420034736021,13,73,86,11.9799995422,0.0,0.0
420034736022,316,293,609,28.7900009155,51.1500015259,48.8499984741
420034736023,197,131,328,47.4000015259,52.9799995422,47.0200004578
420034736024,411,432,843,78.4199981689,70.3700027466,29.6299991608
420034741011,853,784,1637,80.8000030518,70.3000030518,29.7000007629
420034741012,489,463,952,60.4399986267,73.6500015259,26.3500003815
420034741021,629,766,1395,62.3300018311,66.1299972534,33.8699989319
420034741022,595,461,1056,72.9800033569,70.5500030518,29.4500007629
420034742011,116,139,255,9.81000041962,73.9499969482,26.0499992371
420034742021,375,973,1348,60.4199981689,79.6100006104,20.3899993896
420034742022,110,302,412,15.9799995422,77.2399978638,22.7600002289
420034742031,146,695,841,59.5200004578,94.1500015259,5.84999990463
420034742032,88,265,353,50.0699996948,76.0500030518,23.9500007629
420034742033,160,209,369,15.2700004578,24.6499996185,75.3499984741
420034751011,223,87,310,33.6599998474,11.8699998856,88.1299972534
420034751012,476,68,544,64.0800018311,23.7900009155,76.2099990845
420034751013,433,376,809,62.1399993896,60.3499984741,39.6500015259
420034751014,471,280,751,46.0699996948,11.2700004578,88.7300033569
420034751021,468,238,706,42.4000015259,52.0,48.0
420034752001,403,260,663,71.2099990845,67.0899963379,32.9099998474
420034752002,250,398,648,62.4900016785,59.2000007629,40.7999992371
420034752003,506,583,1089,84.9499969482,65.1200027466,34.8800010681
420034752004,525,380,905,54.2200012207,58.4199981689,41.5800018311
420034753011,595,85,680,89.3600006104,17.9500007629,82.0500030518
420034753012,491,120,611,96.8300018311,34.8899993896,65.1100006104
420034753013,287,383,670,33.6699981689,61.8199996948,38.1800003052
420034753014,476,26,502,48.1300010681,7.76000022888,92.2399978638
420034753031,158,0,158,9.13000011444,0.0,100.0
420034753032,346,271,617,51.3699989319,65.6999969482,34.2999992371
420034753033,108,128,236,20.8500003815,73.7099990845,26.2900009155
420034753041,585,278,863,75.6399993896,43.5299987793,56.4700012207
420034753042,449,177,626,33.75,32.3800010681,67.6200027466
420034753043,244,62,306,30.5699996948,49.6300010681,50.3699989319
420034753044,565,359,924,54.6399993896,50.4199981689,49.5800018311
420034754011,600,280,880,65.4300003052,51.1399993896,48.8600006104
420034754012,446,573,1019,60.6199989319,70.3600006104,29.6399993896
420034754013,368,206,574,75.1299972534,55.1300010681,44.8699989319
420034754021,552,199,751,55.1800003052,44.5099983215,55.4900016785
420034754022,291,353,644,37.9000015259,62.8699989319,37.1300010681
420034761001,40,51,91,15.1899995804,0.0,100.0
420034761002,113,75,188,24.2600002289,32.8499984741,67.1500015259
420034761003,411,16,427,49.1899986267,11.6000003815,88.4000015259
420034761004,457,274,731,54.3100013733,29.5400009155,70.4599990845
420034761005,747,55,802,55.4599990845,10.3000001907,89.6999969482
420034762001,399,118,517,70.7300033569,26.7199993134,73.2799987793
420034762002,720,229,949,71.3000030518,24.1599998474,75.8399963379
420034762003,251,320,571,46.7999992371,80.7300033569,19.2700004578
420034771001,207,161,368,30.4599990845,19.1000003815,80.9000015259
420034771002,293,149,442,46.1399993896,52.3800010681,47.6199989319
420034771003,974,261,1235,83.1600036621,32.0600013733,67.9400024414
420034772001,293,149,442,57.1100006104,48.2700004578,51.7299995422
420034772002,382,112,494,72.9700012207,45.3100013733,54.6899986267
420034772003,500,259,759,88.2600021362,51.0400009155,48.9599990845
420034772004,512,320,832,45.4900016785,57.9700012207,42.0299987793
420034773001,0,0,0,0.0,0.0,0.0
420034773002,0,0,0,0.0,0.0,0.0
420034773003,11,4,15,1.33000004292,28.1800003052,71.8199996948
420034773004,324,224,548,54.6399993896,41.4500007629,58.5499992371
420034773005,891,297,1188,71.8700027466,44.75,55.25
420034781001,710,116,826,73.4199981689,16.75,83.25
420034781002,706,21,727,98.1100006104,10.8500003815,89.1500015259
420034781003,1040,98,1138,98.4400024414,13.4099998474,86.5899963379
420034781004,616,83,699,70.3899993896,11.4300003052,88.5699996948
420034782001,921,181,1102,77.9300003052,36.8100013733,63.1899986267
420034782002,651,252,903,42.0400009155,28.9899997711,71.0100021362
420034782003,1378,189,1567,75.8499984741,17.7999992371,82.1999969482
420034790001,557,118,675,80.3600006104,23.9699993134,76.0299987793
420034790002,214,8,222,19.2700004578,0.0,0.0
420034801011,203,165,368,50.1399993896,65.5999984741,34.4000015259
420034801012,410,207,617,61.2099990845,51.0800018311,48.9199981689
420034801013,282,96,378,38.4900016785,25.2999992371,74.6999969482
420034801014,1321,177,1498,70.8899993896,19.9200000763,80.0800018311
420034801021,96,51,147,13.6899995804,0.0,0.0
420034801022,0,0,0,0.0,0.0,0.0
420034801023,0,0,0,0.0,0.0,0.0
420034802001,277,275,552,27.8400001526,73.1200027466,26.8799991608
420034802002,253,131,384,56.2200012207,46.1300010681,53.8699989319
420034802003,411,165,576,75.5899963379,53.2599983215,46.7400016785
420034803001,159,134,293,42.0999984741,26.8199996948,73.1800003052
420034803002,150,219,369,26.8600006104,61.4000015259,38.5999984741
420034803003,371,39,410,74.0100021362,10.1400003433,89.8600006104
420034803004,34,57,91,11.5,0.0,0.0
420034804001,132,474,606,46.4000015259,88.1699981689,11.8299999237
420034804002,2,14,16,1.52999997139,31.3500003815,68.6500015259
420034804003,291,66,357,22.9099998474,24.3099994659,75.6900024414
420034804004,104,27,131,12.2299995422,51.5099983215,48.4900016785
420034810001,775,19,794,97.4199981689,5.78000020981,94.2200012207
420034810002,301,13,314,35.8899993896,0.0,100.0
420034810003,816,78,894,89.8499984741,17.3999996185,82.5999984741
420034810004,184,9,193,26.8799991608,22.4200000763,77.5800018311
420034825001,536,59,595,30.8899993896,20.7900009155,79.2099990845
420034838001,365,48,413,52.5400009155,12.4499998093,87.5500030518
420034838002,1145,23,1168,88.2799987793,4.5,95.5
420034838003,754,49,803,76.0400009155,10.4499998093,89.5500030518
420034843001,822,301,1123,67.3300018311,43.3300018311,56.6699981689
420034843002,125,106,231,42.2299995422,75.0,25.0
420034843003,559,154,713,59.9700012207,0.0,100.0
420034845001,1080,159,1239,70.3199996948,17.5100002289,82.4899978638
420034845002,494,67,561,56.2099990845,0.0,100.0
420034845003,859,36,895,84.5899963379,11.279999733,88.7200012207
420034845004,354,17,371,19.25,3.52999997139,96.4700012207
420034846001,534,0,534,99.2600021362,4.03999996185,95.9599990845
420034846002,649,83,732,81.1500015259,21.9099998474,78.0899963379
420034846003,580,183,763,93.3899993896,42.2299995422,57.7700004578
420034850001,87,253,340,26.75,33.2999992371,66.6999969482
420034867001,821,19,840,56.3400001526,18.6499996185,81.3499984741
420034867002,742,63,805,92.6399993896,11.3100004196,88.6900024414
420034868001,445,138,583,69.9000015259,13.2899999619,86.7099990845
420034868002,622,109,731,73.6200027466,18.8400001526,81.1600036621
420034869001,0,5,5,0.689999997616,0.0,0.0
420034869002,54,76,130,26.9699993134,38.0800018311,61.9199981689
420034869003,22,60,82,47.9500007629,48.4500007629,51.5499992371
420034870001,540,81,621,80.75,38.9700012207,61.0299987793
420034870002,746,105,851,83.3499984741,31.5900001526,68.4100036621
420034881001,621,178,799,71.9800033569,58.1100006104,41.8899993896
420034881002,922,180,1102,91.7600021362,16.2399997711,83.7600021362
420034882001,299,600,899,49.3400001526,60.4399986267,39.5600013733
420034882002,455,82,537,76.0599975586,26.5799999237,73.4199981689
420034882003,386,388,774,72.8099975586,43.9300003052,56.0699996948
420034883001,1013,362,1375,63.2799987793,44.2400016785,55.7599983215
420034884001,583,226,809,65.7699966431,53.2200012207,46.7799987793
420034884002,267,172,439,43.2099990845,59.3499984741,40.6500015259
420034884003,0,181,181,32.6100006104,0.0,0.0
420034884004,801,546,1347,81.5400009155,48.7299995422,51.2700004578
420034885001,157,236,393,46.6199989319,66.1299972534,33.8699989319
420034885002,794,393,1187,86.3300018311,43.5,56.5
420034885003,392,77,469,75.0400009155,26.5300006866,73.4700012207
420034886001,454,57,511,73.6299972534,42.0800018311,57.9199981689
420034886002,196,22,218,22.9699993134,18.3899993896,81.6100006104
420034886003,621,290,911,70.6699981689,58.9500007629,41.0499992371
420034886004,967,193,1160,57.7099990845,54.3199996948,45.6800003052
420034890011,470,77,547,89.8199996948,23.5400009155,76.4599990845
420034890012,874,218,1092,71.75,31.9899997711,68.0100021362
420034890013,1084,400,1484,61.5499992371,39.6399993896,60.3600006104
420034890021,350,191,541,83.8799972534,36.2799987793,63.7200012207
420034890022,488,168,656,52.7299995422,18.3799991608,81.6200027466
420034890023,319,406,725,55.7700004578,67.3499984741,32.6500015259
420034890024,21,34,55,10.2399997711,68.3600006104,31.6399993896
420034900021,292,120,412,42.6100006104,35.5499992371,64.4499969482
420034900022,189,82,271,29.7099990845,72.9199981689,27.0799999237
420034900023,283,168,451,26.5,57.2200012207,42.7799987793
420034900024,252,217,469,76.6299972534,55.0400009155,44.9599990845
420034900025,359,138,497,81.6100006104,37.4500007629,62.5499992371
420034900031,95,91,186,20.0900001526,70.3000030518,29.7000007629
420034900032,690,181,871,84.4000015259,50.7299995422,49.2700004578
420034900033,559,408,967,61.9500007629,59.4700012207,40.5299987793
420034900041,172,523,695,33.5400009155,86.1299972534,13.8699998856
420034900042,331,730,1061,47.0699996948,81.3199996948,18.6800003052
420034900043,216,316,532,69.1800003052,83.8899993896,16.1100006104
420034911011,883,836,1719,61.1100006104,71.0899963379,28.9099998474
420034911012,1341,559,1900,61.7099990845,55.0699996948,44.9300003052
420034912001,764,420,1184,57.9799995422,44.2900009155,55.7099990845
420034927001,485,48,533,99.8099975586,19.9599990845,80.0400009155
420034927002,341,80,421,76.6800003052,27.8999996185,72.0999984741
420034927003,410,235,645,80.7300033569,59.2700004578,40.7299995422
420034928001,923,8,931,77.3300018311,19.1599998474,80.8399963379
420034928002,362,711,1073,68.5599975586,66.7200012207,33.2799987793
420034929001,547,281,828,63.2099990845,34.2900009155,65.7099990845
420034929002,545,142,687,82.2799987793,63.75,36.25
420034940001,1013,314,1327,88.8799972534,37.5499992371,62.4500007629
420034961011,508,261,769,52.5999984741,69.9300003052,30.0699996948
420034961012,446,161,607,40.5999984741,52.6599998474,47.3400001526
420034961021,490,374,864,51.0,56.6399993896,43.3600006104
420034961022,564,342,906,56.6599998474,68.8000030518,31.2000007629
420034962001,270,113,383,31.9699993134,75.5599975586,24.4400005341
420034962002,26,30,56,5.90999984741,88.9800033569,11.0200004578
420034962003,126,104,230,12.7700004578,83.9100036621,16.0900001526
420034962004,104,37,141,24.6900005341,57.6500015259,42.3499984741
420034962005,0,0,0,0.0,0.0,0.0
420034970001,160,172,332,30.9699993134,71.6299972534,28.3700008392
420034980001,0,0,0,0.0,0.0,0.0
420034980002,0,0,0,0.0,0.0,0.0
420034993001,564,6,570,99.6500015259,6.07000017166,93.9300003052
420034993002,279,4,283,28.9699993134,80.8700027466,19.1299991608
420034994001,342,204,546,70.6299972534,33.2299995422,66.7699966431
420034994002,512,72,584,67.75,16.7900009155,83.2099990845
420034994003,1202,0,1202,94.3499984741,0.0,100.0
420035003001,0,15,15,1.07000005245,0.0,0.0
420035003002,0,0,0,0.0,0.0,0.0
420035003003,0,0,0,0.0,0.0,0.0
420035003004,0,0,0,0.0,0.0,0.0
420035010001,1139,202,1341,88.5100021362,24.3999996185,75.5999984741
420035030021,543,108,651,64.0100021362,51.4599990845,48.5400009155
420035030022,738,179,917,74.8000030518,34.6100006104,65.3899993896
420035030023,528,275,803,65.5500030518,31.2399997711,68.7600021362
420035030024,590,92,682,79.0299987793,16.8700008392,83.1299972534
420035030025,342,12,354,21.3500003815,11.4600000381,88.5400009155
420035041001,162,3,165,16.1100006104,0.0,100.0
420035041002,151,100,251,36.4799995422,63.3499984741,36.6500015259
420035041003,148,427,575,72.5999984741,58.8899993896,41.1100006104
420035041004,587,130,717,49.1399993896,47.0699996948,52.9300003052
420035041005,887,173,1060,82.8099975586,50.5699996948,49.4300003052
420035070001,461,198,659,78.0800018311,66.6399993896,33.3600006104
420035070002,1155,87,1242,96.8799972534,16.7800006866,83.2200012207
420035080001,633,141,774,79.0599975586,44.7700004578,55.2299995422
420035080002,425,10,435,35.9199981689,20.9899997711,79.0100021362
420035094001,218,131,349,25.9899997711,0.0,100.0
420035094002,140,238,378,33.0699996948,100.0,0.0
420035094003,265,397,662,83.8000030518,66.7399978638,33.2599983215
420035094004,782,347,1129,97.3300018311,54.7900009155,45.2099990845
420035094005,702,116,818,99.3899993896,32.6399993896,67.3600006104
420035100001,527,234,761,97.6900024414,35.0699996948,64.9300003052
420035100002,604,206,810,77.6600036621,65.7699966431,34.2299995422
420035120001,49,252,301,36.7999992371,39.3699989319,60.6300010681
420035120002,443,295,738,49.2299995422,71.6900024414,28.3099994659
420035128001,454,505,959,69.4899978638,33.8499984741,66.1500015259
420035129001,92,71,163,30.0200004578,84.7600021362,15.2399997711
420035129002,118,0,118,19.1200008392,16.6900005341,83.3099975586
420035138001,339,61,400,45.9199981689,0.0,100.0
420035138002,873,22,895,100.0,7.65999984741,92.3399963379
420035138003,352,3,355,90.3300018311,0.0,0.0
420035140001,446,321,767,93.5400009155,42.25,57.75
420035140002,474,7,481,36.9399986267,9.05000019073,90.9499969482
420035151001,210,39,249,32.5499992371,43.3499984741,56.6500015259
420035151002,1138,80,1218,98.5400009155,9.07999992371,90.9199981689
420035151003,539,100,639,89.0,13.1599998474,86.8399963379
420035152001,0,159,159,15.9499998093,0.0,0.0
420035152002,600,117,717,63.6199989319,21.5400009155,78.4599990845
420035153001,238,0,238,31.3999996185,3.44000005722,96.5599975586
420035153002,0,0,0,0.0,0.0,0.0
420035154011,372,366,738,80.3000030518,59.2200012207,40.7799987793
420035154012,0,153,153,25.3700008392,100.0,0.0
420035154013,466,232,698,93.8199996948,31.5400009155,68.4599990845
420035161001,987,347,1334,95.8300018311,66.2099990845,33.7900009155
420035162001,293,383,676,82.6399993896,74.7399978638,25.2600002289
420035162002,485,320,805,88.6600036621,63.8899993896,36.1100006104
420035170001,0,16,16,2.46000003815,57.4300003052,42.5699996948
420035170002,107,434,541,43.9799995422,82.3199996948,17.6800003052
420035180011,180,417,597,50.8100013733,63.1199989319,36.8800010681
420035180012,223,366,589,46.3400001526,79.8000030518,20.2000007629
420035180013,99,204,303,32.0600013733,72.2799987793,27.7199993134
420035190001,383,440,823,80.2900009155,84.3799972534,15.6199998856
420035190002,385,380,765,53.6100006104,68.5500030518,31.4500007629
420035190003,71,242,313,55.9900016785,82.0899963379,17.9099998474
420035200011,562,277,839,58.6300010681,55.7700004578,44.2299995422
420035200012,483,456,939,52.2200012207,57.7200012207,42.2799987793
420035200021,454,234,688,68.25,68.3399963379,31.6599998474
420035200022,279,221,500,44.1300010681,52.4300003052,47.5699996948
420035200023,148,237,385,39.1300010681,89.4199981689,10.5799999237
420035211001,155,244,399,37.9599990845,82.0,18.0
420035211002,132,283,415,32.1500015259,82.8600006104,17.1399993896
420035211003,1,384,385,17.0300006866,79.9000015259,20.1000003815
420035212001,608,959,1567,82.4300003052,61.7599983215,38.2400016785
420035212002,407,165,572,74.0,23.1599998474,76.8399963379
420035212003,270,484,754,53.25,76.4100036621,23.5900001526
420035213011,579,53,632,77.5500030518,25.1599998474,74.8399963379
420035213012,332,150,482,36.4300003052,23.2399997711,76.7600021362
420035213013,85,81,166,22.0200004578,81.3600006104,18.6399993896
420035213014,381,387,768,57.5699996948,46.0999984741,53.9000015259
420035213021,3,0,3,0.209999993443,0.0,0.0
420035213022,503,33,536,55.3100013733,30.5499992371,69.4499969482
420035213023,541,147,688,51.1100006104,42.6399993896,57.3600006104
420035213024,196,202,398,60.2099990845,71.9300003052,28.0699996948
420035214011,375,506,881,45.7400016785,69.5500030518,30.4500007629
420035214012,200,28,228,24.4599990845,42.2000007629,57.7999992371
420035214021,79,27,106,7.82999992371,71.5999984741,28.3999996185
420035214022,0,0,0,0.0,0.0,0.0
420035214023,0,31,31,2.43000006676,0.0,0.0
420035215001,238,32,270,17.0499992371,43.1199989319,56.8800010681
420035215002,305,380,685,35.5099983215,63.2299995422,36.7700004578
420035215003,359,427,786,94.9300003052,65.1200027466,34.8800010681
420035220001,256,10,266,39.0600013733,58.4599990845,41.5400009155
420035220002,1434,9,1443,87.9899978638,9.81000041962,90.1900024414
420035220003,6,0,6,0.620000004768,0.0,0.0
420035231001,503,398,901,67.6399993896,74.4100036621,25.5900001526
420035231002,242,346,588,43.4599990845,77.6999969482,22.2999992371
420035231003,260,222,482,63.6699981689,53.9700012207,46.0299987793
420035231004,19,202,221,29.3899993896,100.0,0.0
420035232001,825,321,1146,88.1500015259,63.2200012207,36.7799987793
420035232002,442,251,693,69.6500015259,50.6399993896,49.3600006104
420035232003,188,116,304,33.2599983215,53.0600013733,46.9399986267
420035232004,368,246,614,86.1200027466,49.1500015259,50.8499984741
420035233001,181,291,472,63.2700004578,55.8300018311,44.1699981689
420035233002,471,517,988,66.3499984741,48.9000015259,51.0999984741
420035233003,256,146,402,63.7099990845,37.3600006104,62.6399993896
420035233004,438,425,863,64.9800033569,76.2399978638,23.7600002289
420035234001,169,29,198,14.470000267,23.3600006104,76.6399993896
420035234002,498,118,616,81.3700027466,34.9099998474,65.0899963379
420035234003,154,144,298,44.0200004578,89.5500030518,10.4499998093
420035234004,109,28,137,23.7800006866,9.52000045776,90.4800033569
420035234005,516,128,644,65.25,34.7900009155,65.2099990845
420035234006,253,116,369,61.2999992371,19.0400009155,80.9599990845
420035235011,337,465,802,44.1100006104,74.0,26.0
420035235012,439,105,544,36.7099990845,50.5200004578,49.4799995422
420035235013,433,415,848,62.4399986267,53.7599983215,46.2400016785
420035235021,927,322,1249,81.1600036621,55.3800010681,44.6199989319
420035236001,388,433,821,45.1599998474,60.6399993896,39.3600006104
420035236002,525,257,782,84.8199996948,63.7000007629,36.2999992371
420035236003,67,305,372,17.6700000763,98.0999984741,1.89999997616
420035237011,71,55,126,16.5799999237,73.5199966431,26.4799995422
420035237012,111,45,156,8.85999965668,64.0100021362,35.9900016785
420035237013,61,0,61,6.69999980927,0.0,100.0
420035237014,101,94,195,26.0699996948,84.4899978638,15.5100002289
420035237021,755,607,1362,74.2200012207,70.3199996948,29.6800003052
420035237022,655,359,1014,63.4099998474,59.0699996948,40.9300003052
420035237023,534,295,829,72.6600036621,55.9799995422,44.0200004578
420035237024,282,172,454,75.0400009155,9.19999980927,90.8000030518
420035238001,487,399,886,68.7900009155,59.7999992371,40.2000007629
420035238002,366,163,529,64.8300018311,41.5699996948,58.4300003052
420035238003,158,458,616,73.3300018311,82.0999984741,17.8999996185
420035238004,522,629,1151,67.4300003052,66.0699996948,33.9300003052
420035240001,302,142,444,71.5,19.1200008392,80.8799972534
420035240002,620,383,1003,96.8099975586,47.9099998474,52.0900001526
420035240003,90,201,291,35.6199989319,73.7600021362,26.2399997711
420035251001,29,153,182,8.85999965668,95.3799972534,4.61999988556
420035252001,666,221,887,61.9399986267,29.4899997711,70.5100021362
420035252002,349,124,473,82.2600021362,39.9900016785,60.0099983215
420035253001,221,330,551,70.6399993896,68.4499969482,31.5499992371
420035253002,503,690,1193,81.5999984741,71.1999969482,28.7999992371
420035261011,157,269,426,57.2599983215,65.6200027466,34.3800010681
420035261012,539,390,929,36.1199989319,73.5299987793,26.4699993134
420035261013,156,214,370,14.6300001144,81.6999969482,18.2999992371
420035261014,623,305,928,87.8000030518,65.9300003052,34.0699996948
420035261021,270,165,435,20.5200004578,64.4199981689,35.5800018311
420035262011,389,301,690,54.9799995422,74.0599975586,25.9400005341
420035262012,574,519,1093,44.8899993896,65.3000030518,34.7000007629
420035262021,451,629,1080,90.9100036621,77.9300003052,22.0699996948
420035262022,844,540,1384,52.3400001526,72.4300003052,27.5699996948
420035262023,392,563,955,77.7699966431,78.8899993896,21.1100006104
420035263011,506,593,1099,63.7099990845,68.3199996948,31.6800003052
420035263012,382,258,640,26.8899993896,57.5,42.5
420035263021,367,573,940,49.1899986267,68.5,31.5
420035263022,0,0,0,0.0,0.0,0.0
420035263023,163,22,185,15.2299995422,27.1100006104,72.8899993896
420035263024,312,124,436,41.5600013733,38.7200012207,61.2799987793
420035509001,632,69,701,85.3799972534,48.3800010681,51.6199989319
420035509002,987,49,1036,86.7699966431,35.7799987793,64.2200012207
420035512001,488,211,699,64.8399963379,75.8899993896,24.1100006104
420035512002,958,173,1131,99.3000030518,40.2900009155,59.7099990845
420035512003,1046,37,1083,93.9300003052,23.5300006866,76.4700012207
420035513001,554,61,615,64.8099975586,25.5599994659,74.4400024414
420035513002,401,208,609,42.4099998474,52.8300018311,47.1699981689
420035519001,526,46,572,96.9499969482,32.0999984741,67.9000015259
420035519002,724,120,844,96.5699996948,12.1099996567,87.8899993896
420035520001,610,22,632,90.8000030518,4.59000015259,95.4100036621
420035520002,76,105,181,28.8700008392,0.0,0.0
420035520003,598,0,598,100.0,7.07000017166,92.9300003052
420035520004,308,455,763,92.4800033569,53.9300003052,46.0699996948
420035521001,670,64,734,96.5800018311,3.92000007629,96.0800018311
420035521002,623,0,623,90.2900009155,6.67999982834,93.3199996948
420035522001,580,365,945,85.9100036621,41.9000015259,58.0999984741
420035523001,125,60,185,39.5299987793,26.9599990845,73.0400009155
420035523002,7,184,191,40.4700012207,0.0,0.0
420035523003,538,4,542,43.5699996948,10.0399999619,89.9599990845
420035524001,120,142,262,39.4599990845,65.4199981689,34.5800018311
420035524002,325,169,494,50.9799995422,37.5200004578,62.4799995422
420035524003,858,435,1293,93.4199981689,33.4199981689,66.5800018311
420035604001,555,147,702,97.9100036621,24.4200000763,75.5800018311
420035604002,73,93,166,19.7099990845,0.0,0.0
420035605001,121,79,200,20.7700004578,0.0,0.0
420035605002,270,140,410,33.7999992371,18.0900001526,81.9100036621
420035606001,485,0,485,100.0,1.30999994278,98.6900024414
420035606002,169,181,350,59.4199981689,0.0,0.0
420035610001,686,22,708,100.0,24.6299991608,75.3700027466
420035610002,556,293,849,99.7600021362,64.0299987793,35.9700012207
420035611001,545,86,631,74.2399978638,17.8099994659,82.1900024414
420035612001,41,0,41,5.51999998093,0.0,0.0
420035612002,478,13,491,83.2200012207,3.24000000954,96.7600021362
420035614001,66,114,180,28.3899993896,76.5800018311,23.4200000763
420035614002,71,207,278,24.8400001526,41.2900009155,58.7099990845
420035614003,927,114,1041,94.0400009155,24.7399997711,75.2600021362
420035614004,495,615,1110,80.4899978638,73.5899963379,26.4099998474
420035615001,922,537,1459,99.6600036621,65.5800018311,34.4199981689
420035615002,484,293,777,90.6699981689,67.4800033569,32.5200004578
420035615003,709,107,816,99.6299972534,41.8199996948,58.1800003052
420035616001,45,0,45,18.4400005341,0.0,0.0
420035616002,29,5,34,4.63000011444,32.1800003052,67.8199996948
420035616003,431,114,545,100.0,49.4300003052,50.5699996948
420035616004,45,105,150,25.5499992371,100.0,0.0
420035617001,112,70,182,87.0800018311,89.8300018311,10.1700000763
420035617002,114,268,382,75.0500030518,78.0100021362,21.9899997711
420035619001,241,287,528,59.4599990845,62.25,37.75
420035619002,343,381,724,53.8699989319,60.2799987793,39.7200012207
420035620001,1367,0,1367,100.0,0.0,100.0
420035620002,967,112,1079,92.3799972534,35.9799995422,64.0199966431
420035620003,622,85,707,99.3000030518,82.9499969482,17.0499992371
420035623001,381,171,552,99.6399993896,27.1900005341,72.8099975586
420035623002,30,6,36,5.03000020981,40.2299995422,59.7700004578
420035623003,53,29,82,12.6199998856,80.2799987793,19.7199993134
420035623004,437,73,510,100.0,9.48999977112,90.5100021362
420035623005,365,112,477,84.1299972534,34.4199981689,65.5800018311
420035623006,336,132,468,99.1500015259,7.55999994278,92.4400024414
420035624001,130,123,253,31.3099994659,41.0200004578,58.9799995422
420035624002,112,76,188,40.5999984741,48.5499992371,51.4500007629
420035624003,30,47,77,23.5499992371,0.0,0.0
420035624004,542,133,675,91.7099990845,55.0900001526,44.9099998474
420035624005,258,42,300,75.1900024414,14.8900003433,85.1100006104
420035625001,280,16,296,98.3399963379,22.0599994659,77.9400024414
420035625002,130,63,193,32.8800010681,0.0,0.0
420035625003,9,9,18,1.98000001907,0.0,0.0
420035625004,0,0,0,0.0,0.0,0.0
420035626001,207,0,207,81.5,49.5099983215,50.4900016785
420035626002,726,284,1010,100.0,70.4000015259,29.6000003815
420035626003,97,139,236,30.3700008392,40.3100013733,59.6899986267
420035626004,188,99,287,52.8499984741,75.9100036621,24.0900001526
420035627001,455,0,455,98.4800033569,27.9500007629,72.0500030518
420035627002,872,2,874,93.6800003052,40.3499984741,59.6500015259
420035628001,164,317,481,84.3899993896,78.2600021362,21.7399997711
420035628002,598,360,958,93.2799987793,65.0599975586,34.9399986267
420035629001,474,0,474,74.6500015259,23.8999996185,76.0999984741
420035629002,256,46,302,83.4300003052,63.8100013733,36.1899986267
420035629003,344,416,760,82.0699996948,60.6199989319,39.3800010681
420035630001,95,446,541,53.9900016785,71.9000015259,28.1000003815
420035630002,526,180,706,93.5100021362,25.7999992371,74.1999969482
420035630003,109,417,526,85.6699981689,83.0699996948,16.9300003052
420035630004,11,0,11,2.30999994278,0.0,100.0
420035631001,231,392,623,62.9300003052,68.6800003052,31.3199996948
420035631002,1075,712,1787,86.0800018311,48.6800003052,51.3199996948
420035631003,65,383,448,94.1200027466,75.6500015259,24.3500003815
420035632001,270,14,284,93.7300033569,5.26000022888,94.7399978638
420035632002,842,0,842,86.8899993896,2.29999995232,97.6999969482
420035632003,900,0,900,78.2600021362,7.03000020981,92.9700012207
420035633001,42,108,150,23.4699993134,81.2799987793,18.7199993134
420035633002,56,205,261,32.2200012207,96.7799987793,3.22000002861
420035638001,206,107,313,44.9099998474,69.4300003052,30.5699996948
420035638002,18,32,50,2.6099998951,65.1699981689,34.8300018311
420035638003,126,25,151,73.6600036621,54.3100013733,45.6899986267
420035638004,37,2,39,55.7099990845,43.2099990845,56.7900009155
420035638005,248,224,472,86.2900009155,78.5,21.5
420035638006,0,0,0,0.0,0.0,0.0
420035639001,144,189,333,41.6199989319,52.4799995422,47.5200004578
420035639002,349,567,916,73.2200012207,44.9199981689,55.0800018311
420035639003,514,0,514,57.6199989319,0.0,100.0
420035639004,59,1,60,6.09999990463,2.55999994278,97.4400024414
420035640002,704,198,902,40.2099990845,52.2400016785,47.7599983215
420035640003,134,58,192,50.1300010681,28.3500003815,71.6500015259
420035641001,148,265,413,96.7200012207,71.8099975586,28.1900005341
420035641002,10,165,175,38.4599990845,97.3000030518,2.70000004768
420035642001,0,0,0,0.0,0.0,0.0
420035642002,266,78,344,36.9099998474,42.7299995422,57.2700004578
420035642003,228,58,286,30.3899993896,63.7200012207,36.2799987793
420035644001,498,107,605,61.9199981689,29.7000007629,70.3000030518
420035644002,44,0,44,3.82999992371,0.0,100.0
420035644003,499,56,555,54.9500007629,31.7900009155,68.2099990845
420035644004,669,355,1024,82.1800003052,39.9900016785,60.0099983215
420035644005,259,190,449,74.3399963379,61.3300018311,38.6699981689
420035644006,52,103,155,26.7199993134,90.8099975586,9.18999958038
420035644007,1,3,4,7.40999984741,65.3399963379,34.6599998474
420035645001,1110,282,1392,89.2300033569,37.1699981689,62.8300018311
420035645002,344,114,458,40.7099990845,53.0800018311,46.9199981689
420035645003,433,78,511,98.6500015259,21.2700004578,78.7300033569
420039800001,361,179,540,100.0,41.5299987793,58.4700012207
420039801001,3,2,5,27.7800006866,76.8600006104,23.1399993896
420039803001,0,1,1,100.0,100.0,0.0
420039804001,5,0,5,23.8099994659,97.9800033569,2.01999998093
420039805001,4,5,9,33.3300018311,76.4899978638,23.5100002289
420039806001,9,0,9,81.8199996948,3.47000002861,96.5299987793
420039807001,16,0,16,84.2099990845,27.9099998474,72.0899963379
420039808001,-99999,-99999,-99999,-99999.0,20.1000003815,79.9000015259
420039809001,1562,200,1762,98.0500030518,22.5400009155,77.4599990845
420039810001,2,1,3,75.0,72.0599975586,27.9400005341
420039811001,4,1,5,71.4300003052,81.6200027466,18.3799991608
420039812001,-99999,-99999,-99999,-99999.0,0.800000011921,99.1999969482
420039818001,79,258,337,73.0999984741,98.4000015259,1.60000002384
420039822001,1374,39,1413,29.3400001526,23.4400005341,76.5599975586
